111111111111
1..........1
1.....2....1
1P........E1
1..........1
1...2...2..1
1..........1
111111111111
