11111111111111111111
1.2....E..22.......1
1..............2...1
1...2.......2.22...1
122......2......E.21
1.....2....2...2.2E1
1......2...........1
12.2....E....22....1
1..................1
12............2.2..1
1.2.......P....2..21
1.2....E.......2..21
1.E...2.......2....1
12...........E.....1
1..............E...1
1E...22...E.2......1
1.2.........2.....E1
12.E...............1
1......E.....2.....1
11111111111111111111
