11111111111111111111
1..................1
1..............2...1
1.EE.....2..E......1
1....222....2.22...1
1.2................1
1................E.1
1.......E.........21
1EE................1
1......2..22.......1
1........EP........1
1.........2..2.....1
1..E.2.............1
1...E.E2...........1
12.......E.........1
12.2...............1
1................2.1
1....2.E.......22..1
1..22..............1
11111111111111111111
