11111111111111111111
1.2.......22.......1
1..............2...1
1...2.......2.22...1
122......2........21
1.....2..E.2...2.2.1
1......2...........1
12.2.........22....1
1..................1
12............2.2..1
1.2.......P....2..21
1.2............2..21
1.....2.......2....1
12.................1
1..................1
1....22.....2......1
1.2.........2......1
12.................1
1............2.....1
11111111111111111111
