11111111111111111111
1..................1
1....E2.....2.2....1
1.........E.2..2.E.1
1.......2..........1
1.2......2.........1
1....2.......E..2..1
1....2.......2..2..1
1.....2......2...2.1
1E......2....2.2...1
1.........P........1
1..E........2.....21
1................E.1
1......2..2......C.1
12............E....1
1...E...2...2......1
12...2.....2..2....1
1........2...2.....1
1.E...2............1
11111111111111111111
