11111111111111111111
1.......2E.....2...1
1..2..........2..2.1
1..................1
1....2...........2.1
1....2.2...........1
12.....2........2E.1
1......E.........2.1
1.22..E...2.2......1
1.2................1
1..E......P........1
1..E........2...2..1
1.......2E....EE...1
1...E....2.2..2....1
1.......2.......2..1
1............22...21
1...2.....2E..2....1
1E........2......221
1.....22........2..1
11111111111111111111
