11111111111111111111
1..2..2.........2..1
1........2...2.....1
1..............2...1
1E.................1
1...2........2.....1
1...2.2..E...2..2..1
1.....2....2......21
1....22............1
1.....E......2.....1
1......2..P....2...1
1.2......2.........1
12....E2.2.......2.1
1.2................1
1.22......2........1
1.....2............1
1.....2....E.2.....1
1.2...............21
1............2.....1
11111111111111111111
