11111111111111111111
1..2......2.2......1
1..2.........2.E...1
1..........E.2.....1
1....2...2..2.....21
1...2.2............1
12.22...2....2.E..21
122...2.......E....1
1.........22.......1
1.2.....E2..2.2....1
1....2....P..2..2..1
1..................1
1...........2......1
1....2..2......2...1
1E.2..E..2.........1
1E.2....22...2.....1
1.2....E........E..1
1.......E.E2..2...21
1...E..............1
11111111111111111111
