11111111111111111111
12.E........2..2...1
1......2..2.E......1
12....2......2....21
1..2...2..2........1
1...E2.....E..22.2.1
1E....E.2..........1
1..2...............1
1......2...2.......1
1.......22.......2E1
122....E..P......2.1
1....2....2........1
1....2.2......2.2..1
1...E..2...........1
1.2..........2.....1
1.22....E.2........1
1...........E......1
12..22..2..........1
1............22....1
11111111111111111111
