11111111111111111111
1E................21
12.2...............1
1...2.2.......2....1
1.2....2...2.2.....1
1..................1
1...2...2...E.2....1
1...2..............1
1...E.22E........221
1..E2....2..2......1
1.......E.P........1
12.2.....2....E....1
1..2........E2.....1
1.....2.2.........21
1..2....E....2.2...1
1.2...........2....1
1...2...........2..1
1...2..........2.E.1
1..E.2..2......E..21
11111111111111111111
