11111111111111111111
1...2..2...........1
1........E.........1
1.....2........2...1
1................2.1
1.......2......2...1
1..2........2......1
1...........E.2....1
12..2....2.2..E.2..1
12.....2...........1
1.........PE......21
1.2.......2.....2E.1
1........2..E..2...1
1...........2.2....1
1.2..........2.....1
1...2..............1
1..................1
1.2.....2.....2...21
1.........22...22..1
11111111111111111111
