11111111111111111111
122.E2...........2.1
1..2...E...........1
1.................E1
1....2.....E.......1
1............2....21
1.2.........E......1
1..2...2.....22....1
1..............2...1
1..2.........2.....1
1.........P2......21
1.....2....E.......1
1..2..........2E...1
1.....2.........2..1
1...22........E....1
1..................1
1...2...2..........1
1..2..E....2....2..1
1E2...2....2.......1
11111111111111111111
