11111111111111111111
1..........2.2.....1
1..................1
1........E..2......1
1.................21
1..............2...1
1....2.E2..2.2....E1
1E..E..............1
1.....2.2.22.2.....1
1222.......2....2..1
1.........P.2.2...21
1.22......22......21
1.2..........222.2.1
1...............2..1
1.....2.....E2..2..1
1..................1
1.............2....1
1..............2...1
122.2...22.........1
11111111111111111111
