11111111111111111111
1..2....2..........1
1..C....2.2..E.....1
1..2....E...2......1
1...........2......1
1.2...2.E...E....2.1
1...2E...E.....2...1
1.........2........1
1.......E.2..E.....1
1....C.............1
1..2...E..P2...2...1
1..222...2....E..2.1
1..........2E.2....1
1.E......2.........1
1.....E.2....2.....1
1..................1
1.....E.2......22..1
1..................1
1....E.............1
11111111111111111111
