11111111111111111111
1.2...............21
1..................1
1.EE2...........2..1
1.......22....E....1
1.......2.2........1
12...........2..2..1
12...E2.2...E..22C.1
1..2........E.....21
1..E.......2.......1
1.........P2.......1
1...E....E22.....2.1
1...2..............1
1.2.....E..22.22...1
1...E..........E..21
12.......2.2.......1
1..........22......1
1..........E.......1
122......2.........1
11111111111111111111
