11111111111111111111
1............22....1
1.......2.......E..1
1..................1
1E2.....2..E..2....1
1..............2...1
1....2....2....2...1
1......2......2....1
1...E.......2.....E1
1..........E.2.....1
1....2....P........1
1.......2E...2.2..21
1...2...2.E....E...1
1...........2...2..1
1..............2...1
1...2.....2..2.....1
1...2.....2.....2.21
1............2.E...1
122................1
11111111111111111111
