11111111111111111111
1.......E....2...2.1
1....2.2...........1
1......E...2.....E21
1.....2..2....2....1
1..................1
1.......2E..2......1
1..................1
1.2................1
1....2.E..E...2....1
12........P........1
1..............E2..1
1........2....2....1
1.......2..........1
1..................1
1..........2..C2..21
12..............2..1
12.....E.2.22...2.21
1.................E1
11111111111111111111
