11111111111111111111
1...E.......2......1
1............2.....1
1...2..............1
1...2..2.2..2......1
1.........2.2...2.E1
1.........2.....E..1
1........2......2..1
1.......E..........1
12...........2...2.1
1.....2..EP......2.1
1.2........2.2E....1
1....2..2..........1
1.....2E.2.........1
1E2...2............1
1.........22......21
1....E.E.........221
1........2.........1
1...22.......2.E..21
11111111111111111111
