11111111111111111111
1........2...E2..2.1
1..................1
1.............22...1
1.........E........1
1.2..2.............1
1..................1
1..........2..E..2.1
1..................1
1.......2..2.......1
1.........P.E..E...1
1...E..............1
1.....E.......22..E1
1....2............21
12.E......E........1
1.2...E.2..........1
12.................1
1...E2........22...1
1.2..2...2...E.....1
11111111111111111111
