11111111111111111111
1.......2..........1
1.2.........E..2EE.1
1.........2....2...1
1....2..........E..1
1.....2E.....22....1
1..2...............1
1.2.....2...2.2....1
1E......2....E.....1
1......E..2........1
1.........P........1
1.....2....2.......1
1..E...............1
1....2..22.........1
12......2..........1
1......22..........1
1..............E..21
1....2.2....2......1
1..22...........2.E1
11111111111111111111
