11111111111111111111
12.....2...........1
1..................1
1.............2....1
1E..22.2.......2E..1
12E.2.2............1
1...22E2.22........1
1.2E...2...2.......1
1.....E....22......1
1......2..........21
1......2..P......2.1
1.....2...22....E..1
1.....2..E.........1
1.....E.EE........21
1.....E..2.......2.1
1...2..2..E..EE....1
12............2....1
1...............2..1
1..........2E.2....1
11111111111111111111
