11111111111111111111
1...2..............1
12..2......2....2..1
1....2..2..2.......1
1.......2.....EE...1
1......2E22...2....1
1..............2...1
1...2.2.2.......E..1
1E2.2.......2......1
1................E.1
1.....2..EP........1
1....2...E...2...E.1
1..2.2.2......22...1
1..2..........222..1
1E....E............1
1..2...2E.2....2...1
1...2..E.2........21
1........E.........1
12.....22.E....2...1
11111111111111111111
