11111111111111111111
1.E.......2........1
1....2.2......2.2..1
1...........2......1
1.E.E..E.....2.....1
1....2..2..2...22..1
1..........E.......1
1E..E2......2......1
1.22..............21
1..................1
1E.2E....EP.2E...E.1
1..2E..22...E......1
1...2.2........2...1
1..................1
1......2...........1
1.......22.........1
12......2.....2....1
1.....2.2.........21
1....E..2..........1
11111111111111111111
