11111111111111111111
12E22........E2..2.1
1....E.........2...1
1....2.......E.....1
1.............2....1
1..................1
1...2.E............1
1.......2....2.2..21
1....2.......2.2.E.1
12.........E......21
12....2..2P........1
1.2...2............1
1......2...2E......1
1...2.......22....21
1.......2..2.......1
1....2..........2221
1....2.............1
12......E...2.....21
1..................1
11111111111111111111
