11111111111111111111
1......2...........1
1....2.......2..2..1
12.........2.E.....1
12............2....1
1.......2.......2..1
1.............2....1
12.2..2.22.2E......1
1...E..............1
12.........E.......1
1.2.......P.....2.21
1..2...............1
1.....2......2.....1
1..222..........E..1
1..E...............1
1..2.......2..E.2..1
12....22.......2...1
1......2..2........1
1E...2..2......E...1
11111111111111111111
