11111111111111111111
1E.........E...2..21
1..2........E......1
1..2...2E....E.....1
1.......2.....2..2.1
1...2......E.2....E1
1.2...............21
1E....2....2.......1
1.....2............1
1..2.......2.......1
1.......2EP.2......1
12.......2.........1
1.......2..........1
1......2E....22...E1
1.......2...2......1
1..................1
1...2.22....2..2.2.1
1.2....2.......E2..1
1....2...2..2......1
11111111111111111111
