11111111111111111111
1..E..E.........2.21
1...2.......222....1
1..................1
1..................1
12.........E2..2...1
1....2..2..........1
1.......2.2........1
1........2E........1
1.22.........2.E...1
1...2.....P........1
1..2......22.......1
1......2.222.......1
1.......2..........1
1...2..............1
1....2.2.....E2....1
1......2.....2....21
1...2.E.2..........1
1..2......2....E2..1
11111111111111111111
