11111111111111111111
1......2.2...2.22..1
1...........2....E.1
1.........2......2.1
1..2...E........2..1
1E.......2......2..1
12..E.2.2.........21
1..2.......2.......1
1.....E..........E.1
1E.2...........2..21
1..2......P2..E....1
1.2...........2.E..1
1....2.............1
12............E.2..1
1.............2...21
1....2...2E.....2..1
1..2...............1
1.......22.........1
1...E2.E22.........1
11111111111111111111
