11111111111111111111
1........EEE..E....1
1........2.....2.2.1
1...2.....2......E.1
1...........E.....21
1..2.2.........E...1
12..22..........E.21
12...2.....2.2.2...1
1.......2.........E1
1...2........2.....1
1....E....P........1
1....2......2......1
1..................1
1.......2..........1
1E......22.....E2..1
1...2..2E.......2.21
1.....2...2....2..21
1.............2....1
1..E..........2....1
11111111111111111111
