11111111111111111111
1..................1
1.......2..........1
1......E..E2.......1
1........2..2......1
1..E....2.2...2...21
1.......E.....2....1
1...............2..1
1...2....E.....2..21
12..E.......2......1
1.........P.......E1
1.2.2..........2...1
12........2..E.....1
1..E...............1
1.22......E.2......1
1........2..E...2..1
1..2.....E2.....22.1
1...EE.........2...1
1..........22E.....1
11111111111111111111
