11111111111111111111
1...2..............1
1............2..2..1
1E.2..............21
1...2..2......2....1
122.............2..1
1.2........E.......1
1.........E...E.E..1
1...2...........E..1
1..................1
1....2....P...2....1
1.......2..2.......1
1.2..E....2...2....1
1...........2....E.1
1.......22.E......E1
1...2....2..2.2..2.1
12E...22........2..1
1......2....E2.2...1
1..........22.E....1
11111111111111111111
