11111111111111111111
1..22.2.E.E........1
1.2......2......22E1
1...2E.......2....21
1...2.....2........1
1.........E.2.2.2..1
1...2..........2...1
1.......2..2.......1
1E.....2.....2.....1
1.22........E..2...1
1........EPE.......1
1.........E....2.221
1...2..............1
1..2..E.2..........1
1.........E........1
1..........E..E....1
1.2.........2......1
1E......2....2.....1
1..................1
11111111111111111111
