11111111111111111111
1.....E.....2....2.1
1.2...2.....2.....21
1.........2........1
1..2..E......2....21
1.....2......2.....1
1........2..2......1
1.22......E.2.....21
1..2...............1
1E.E...............1
12........P2.2.....1
1E...............2.1
1.2E..........2....1
1....E.............1
1..2......2....22..1
1........E2.....22.1
1.......2...2......1
1..2.2.2........22.1
1........22......221
11111111111111111111
