11111111111111111111
1..E.2............21
12..2.2.E.2.....E..1
1E...2.......22E...1
1...2.....E..E.2...1
1.2....E2..........1
1.E........E.......1
1.2.............E..1
1E2.....2.....2.2E.1
12....2......2..2..1
1.........P..E.....1
1...2.2.2.........E1
1...2...2......22..1
1...........2....2E1
1.......2..........1
1...22.2E....2.....1
1..............2...1
1.2...22....2......1
1........2.....2...1
11111111111111111111
