11111111111111111111
1....2.............1
1.......2....2.....1
1....2.2......E....1
1.2......2.E.......1
1..E....22.....E...1
1..........22..22.E1
1.....2.....2...E..1
1....E............E1
1...2........E.2..21
1....2....P........1
1........2....2....1
1..2....2..........1
1.......2........2.1
1.2...............21
1.2.2........2..2..1
1......C..2........1
1.........E..2..2..1
1........222E.2..2.1
11111111111111111111
