11111111111111111111
12......2........2.1
1....2.2E.....2..E.1
1.....2.........2..1
12....E.....E.E....1
1.E.....2..........1
1...2....2.......E.1
12.2..2..2......2..1
1.......2..........1
12E............2...1
1.2.2.2...P........1
12..2....2E........1
1..............E...1
1..................1
12...............C.1
1....2...2.....22..1
1.......E2...2.2...1
1..E...........E...1
1.2..E.2.E.....E2E.1
11111111111111111111
