11111111111111111111
1.......2.......22.1
1........2.........1
1.2................1
1...E..............1
1..E......E..2.2...1
1..................1
1.E2...E...........1
1........2........21
1....2....22.2.....1
12...2..2.P2.......1
1.....E..2....2...21
1......2...........1
1..22..........2...1
122.....2..2.......1
1E............2....1
1.........E.2....2.1
12.........E.......1
1.........2...2....1
11111111111111111111
