11111111111111111111
1.22..2.....2......1
1..........22......1
1..........2...E2..1
1..................1
1..2......2........1
1..........E.22....1
1....2..22.....2...1
1..............E...1
1.2................1
1..2......P........1
1.2E.........2.....1
1.E.....2...E......1
1......2...........1
1...2...2...2.....E1
1.......E..........1
1....22............1
1.......2..E2.....21
1.......2C....2....1
11111111111111111111
