11111111111111111111
1.2................1
1..............2...1
1.EE2...E2E.22.....1
12...........2.....1
1.2....2...........1
1.E..............2.1
1...2............2.1
1..2......2.2......1
12...2.............1
1.......2.P.2.2....1
1........2........21
1...........2..E...1
12...2..2E..2.2E...1
1......2......2..2.1
12.........2.......1
1.......2.E........1
1.......2..2...E...1
1................2.1
11111111111111111111
