11111111111111111111
1..2.....2.2..E....1
1E...2............E1
1...2.......2......1
1............2.....1
1...2..........2.2.1
1.2...2....2.....2.1
1..............2.2.1
1......2...........1
1..2.2.2...........1
1.........P.......21
1....2...2..E......1
1...2....2.E.....2.1
1.....2.......2....1
1222......2.....2..1
1.2....2.......2...1
1......E2E........21
1.......2........E.1
1.....2.........2..1
11111111111111111111
