11111111111111111111
1.2.....E.....E....1
1......2.2........21
1E.2...2........2..1
1......2...........1
12..........E....2.1
1..................1
122....E.2.........1
1..2..E........22..1
1..................1
1...2..2..PE.......1
1..2...............1
1.....E........E..21
12...........2.....1
1..................1
1...........22.2...1
1.........2.....2..1
1..................1
1E................E1
11111111111111111111
